-15
19
-10
10
00000000000000000000000000000000000
11111111111111111111111111111111110
10000000000000000000000000000000010
10000000000000000000000000000000010
10000000000000000111111100000000010
10000000000000000111111100000000010
10000000000000000111111100000000010
10000000000000000111111100000000010
10000000000000000111111100000000010
10000000000000000111111100000000010
10000000000000000111111100000000010
10000000000000000000000000000000010
10000000000000000000000000000000010
10000000000010000000000000000000010
10000000000000000000000000000000010
10000000000000000000000000000000010
10000000000000000000000000000000010
10000000000000000000000000000000010
10000000000000000000000000000000010
10000000000000000000000000000000010
11111111111111111111111111111111110
