-7
9
-3
8
00000000000000000
00000000000000000
00000000011111110
00000000011111110
00000000011111110
00000000011111110
00000000011111110
00000000011111110
00000000011111110
00000000000000000
00000000000000000
00001000000000000
