-20
24
-14
14
000000000000000000000000000000000000000000000
111111111111111111111111111111111111111111110
100000000000000000000000000000000000000000010
100000000000000000000000000000000000000000010
100000000000000000000000000000000000000000010
100000000000000000000000000000000000000000010
100000000000000000000000000000000000000000010
100000000000000000000000000000000000000000010
100000000000000000000011111110000000000000010
100000000000000000000011111110000000000000010
100000000000000000000011111110000000000000010
100000000000000000000011111110000000000000010
100000000000000000000011111110000000000000010
100000000000000000000011111110000000000000010
100000000000000000000011111110000000000000010
100000000000000000000000000000000000000000010
100000000000000000000000000000000000000000010
100000000000000001000000000000000000000000010
100000000000000000000000000000000000000000010
100000000000000000000000000000000000000000010
100000000000000000000000000000000000000000010
100000000000000000000000000000000000000000010
100000000000000000000000000000000000000000010
100000000000000000000000000000000000000000010
100000000000000000000000000000000000000000010
100000000000000000000000000000000000000000010
100000000000000000000000000000000000000000010
100000000000000000000000000000000000000000010
111111111111111111111111111111111111111111110
