-3
5
-3
7
000000000
011111110
011111110
011111110
011111110
011111110
011111110
011111110
000000000
000000000
100000000
